

SO ./asset/bluestone.xpm
WE  ./asset/colorstone.xpm
EA  ./asset/eagle.xpm

NO  ./asset/redbrick.xpm
C   128,127,255
F   200,100,157


 1 1 1   1 1 1 1 1 1 1 1 11 1 1 1 1 1 
 1 1 1 1101 1 1 1 1 11101 1 1 111111 
 111111111 1 1 1 11 1101 1 1 10000001 1
 11 1 1 11 1 1 1 1 1 111 1 110S11111111
 11111111111111111111111111111111111111

