C   0,+0000000159,247








F   245,245,171

SO                                                                  ./asset/bluestone.xpm

WE                                        ./asset/colorstone.xpm

EA  ./asset/eagle.xpm


NO  ./asset/redbrick.xpm
                  111
            111111101                                                  111
            1     111                                                  101
            1                                                          111
        111111111111111111111
     1111110000000000000000111111111
        101111111000000000111111111111111
       111111111110000000000000011111111
                  1111111111111111111111111111111111
         111111111111111111111111101111111
         11111111111111111111111111111111111111
         1111011
         11111
         1 1 1
         11011
         11111   111111 
         10101   110011
         11111   1010101
         1111 111 111111 1
                                        11111111111
                 1                      101
                 1                      111
                 1                      1 1 1 1 1 1 1 1 1 1 1 1 1 1
                                         1 1 1 1 1 1 1 1 1 1 1 1 1
                                        1 1 1 1 1 1 1 1 1 1 1 1 1 1

        11111111111111111111111111111111
        10000000000000000000000000000001
         11111111111111111111111111111111
        1000000011       111110000000001
        1000000011       1  110000000001
        1000000011   11111  110000000011
        100W000011   1 1  1 110000000011
        1000000011   1 1 1  110000000011
        1000000011 1 11111  110000000011
        1000000011         1111000000001
        11111011111111111111111111111111
        11111111111111111111111111111111
        11111111111111111111111111111111



        11111111111111111111111111111111
        100000000000000000000000000000011111111111111111111
        111111111111111111111111111111111111111111111111111
        1000000011 111111111110000000001
        1000000011 1        110000000001
        1000000011 1 111111 110000000001111111111111111111
        1001110011 1 1    1 110000000001111111111111111111
        1001 10011 1 1 11 1 110000000001
        1001110011 1 1  1 1 110000000001111111111111111111
        1000000011 1 1111 1 110000000001111111111111111111
        1000000011 1      1 110001110011
        1000000011 11111111 110001 10011
        1000000011         1111001110001111111111111111111
        11111111111111111111111111111111110101111111111111
        1111       11111111111111111   111111111
        111111111111111111111111111
        111111111111111